11111111111111111111
100P1000C100100000E1
10001000010010111111
101110000100101000C1
10000000000000000001
10011111111111111001
10000000C00000000001
11111111111111111111